11111111111111111111111111111
100000000000000C0000100000001
100000000000000C0000100000001
100000000000000C0000100000001
1000000000E0000000000000P0001
100000000000000C0000100000001
11111111111111111111111111111