11111111111111111111111111111
10000000010000000000100000001
10000000000000010000100000001
10000000000000100000100000001
1000000000E0000100000000P0001
100000000000000C0000100000001
11111111111111111111111111111
