111111111111111111111111111111
101000000000000C00001000000001
100C0000C000000C00001000000001
10000010C000000C0000C000000001
100C001000E0000000001000P00001
100C00100000000C00001000000001
111111111111111111111111111111