11111111111111111111111111111
10C000000100000C0000100000001
1000C000000000010000100000001
100000C00000001C0000100000001
100000C000E0000100000000P0001
100C00000000000C0000100000001
11111111111111111111111111111